UUUUUUUUUUUUUUUUUUUUUUUUUUUUUUUU.SSSSSSSSSSSSSSSSSSSSSSSSSSSSSSSSSSSS.TTTTTTTTTTTTTTTTTTTTTTTTTTTTTTTTTTTTTTTTT
UUUUUUUUUUUUUUUUUUUUUUUUUUUUUUUU.SSSSSSSSSSSSSSSSSSSSSSSSSSSSSSSSSSSS.TTTTTTTTTTTTTTTTTTTTTTTTTTTTTTTTTTTTTTTTT
UUUUUUUUUUUUUUUUUUUUUUUUUUUUUUUU.SSSSSSSSSSSSSSSSSSSSSSSSSSSSSSSSSSSS.TTTTTTTTTTTTTTTTTTTTTTTTTTTTTTTTTTTTTTTTT
UUUUUUUUUUUUUUUUUUUUUUUUUUUUUUUU.SSSSSSSSSSSSSSSSSSSSSSSSSSSSSSSSSSSS.TTTTTTTTTTTTTTTTTTTTTTTTTTTTTTTTTTTTTTTTT
UUUUUUUUUUUUUUUUUUUUUUUUUUUUUUUU.SSSSSSSSSSSSSSSSSSSSSSSSSSSSSSSSSSSS.TTTTTTTTTTTTTTTTTTTTTTTTTTTTTTTTTTTTTTTTT
UUUUUUUUUUUUUUUUUUUUUUUUUUUUUUUU.SSSSSSSSSSSSSSSSSSSSSSSSSSSSSSSSSSSS.TTTTTTTTTTTTTTTTTTTTTTTTTTTTTTTTTTTTTTTTT
UUUUUUUUUUUUUUUUUUUUUUUUUUUUUUUU.SSSSSSSSSSSSSSSSSSSSSSSSSSSSSSSSSSSS.TTTTTTTTTTTTTTTTTTTTTTTTTTTTTTTTTTTTTTTTT
UUUUUUUUUUUUUUUUUUUUUUUUUUUUUUUU.SSSSSSSSSSSSSSSSSSSSSSSSSSSSSSSSSSSS.TTTTTTTTTTTTTTTTTTTTTTTTTTTTTTTTTTTTTTTTT
UUUUUUUUUUUUUUUUUUUUUUUUUUUUUUUU.SSSSSSSSSSSSSSSSSSSSSSSSSSSSSSSSSSSS.TTTTTTTTTTTTTTTTTTTTTTTTTTTTTTTTTTTTTTTTT
UUUUUUUUUUUUUUUUUUUUUUUUUUUUUUUU.SSSSSSSSSSSSSSSSSSSSSSSSSSSSSSSSSSSS.TTTTTTTTTTTTTTTTTTTTTTTTTTTTTTTTTTTTTTTTT
UUUUUUUUUUUUUUUUUUUUUUUUUUUUUUUU.SSSSSSSSSSSSSSSSSSSSSSSSSSSSSSSSSSSS.TTTTTTTTTTTTTTTTTTTTTTTTTTTTTTTTTTTTTTTTT
UUUUUUUUUUUUUUUUUUUUUUUUUUUUUUUU.SSSSSSSSSSSSSSSSSSSSSSSSSSSSSSSSSSSS.TTTTTTTTTTTTTTTTTTTTTTTTTTTTTTTTTTTTTTTTT
UUUUUUUUUUUUUUUUUUUUUUUUUUUUUUUU.SSSSSSSSSSSSSSSSSSSSSSSSSSSSSSSSSSSS.TTTTTTTTTTTTTTTTTTTTTTTTTTTTTTTTTTTTTTTTT
UUUUUUUUUUUUUUUUUUUUUUUUUUUUUUUU.SSSSSSSSSSSSSSSSSSSSSSSSSSSSSSSSSSSS.TTTTTTTTTTTTTTTTTTTTTTTTTTTTTTTTTTTTTTTTT
UUUUUUUUUUUUUUUUUUUUUUUUUUUUUUUU.SSSSSSSSSSSSSSSSSSSSSSSSSSSSSSSSSSSS.TTTTTTTTTTTTTTTTTTTTTTTTTTTTTTTTTTTTTTTTT
UUUUUUUUUUUUUUUUUUUUUUUUUUUUUUUU.SSSSSSSSSSSSSSSSSSSSSSSSSSSSSSSSSSSS.TTTTTTTTTTTTTTTTTTTTTTTTTTTTTTTTTTTTTTTTT
UUUUUUUUUUUUUUUUUUUUUUUUUUUUUUUU.SSSSSSSSSSSSSSSSSSSSSSSSSSSSSSSSSSSS.TTTTTTTTTTTTTTTTTTTTTTTTTTTTTTTTTTTTTTTTT
UUUUUUUUUUUUUUUUUUUUUUUUUUUUUUUU.SSSSSSSSSSSSSSSSSSSSSSSSSSSSSSSSSSSS.TTTTTTTTTTTTTTTTTTTTTTTTTTTTTTTTTTTTTTTTT
UUUUUUUUUUUUUUUUUUUUUUUUUUUUUUUU.SSSSSSSSSSSSSSSSSSSSSSSSSSSSSSSSSSSS.TTTTTTTTTTTTTTTTTTTTTTTTTTTTTTTTTTTTTTTTT
UUUUUUUUUUUUUUUUUUUUUUUUUUUUUUUU.SSSSSSSSSSSSSSSSSSSSSSSSSSSSSSSSSSSS.TTTTTTTTTTTTTTTTTTTTTTTTTTTTTTTTTTTTTTTTT
UUUUUUUUUUUUUUUUUUUUUUUUUUUUUUUU.SSSSSSSSSSSSSSSSSSSSSSSSSSSSSSSSSSSS.TTTTTTTTTTTTTTTTTTTTTTTTTTTTTTTTTTTTTTTTT
UUUUUUUUUUUUUUUUUUUUUUUUUUUUUUUU.SSSSSSSSSSSSSSSSSSSSSSSSSSSSSSSSSSSS.TTTTTTTTTTTTTTTTTTTTTTTTTTTTTTTTTTTTTTTTT
UUUUUUUUUUUUUUUUUUUUUUUUUUUUUUUU.SSSSSSSSSSSSSSSSSSSSSSSSSSSSSSSSSSSS.TTTTTTTTTTTTTTTTTTTTTTTTTTTTTTTTTTTTTTTTT
UUUUUUUUUUUUUUUUUUUUUUUUUUUUUUUU.SSSSSSSSSSSSSSSSSSSSSSSSSSSSSSSSSSSS.TTTTTTTTTTTTTTTTTTTTTTTTTTTTTTTTTTTTTTTTT
UUUUUUUUUUUUUUUUUUUUUUUUUUUUUUUU.SSSSSSSSSSSSSSSSSSSSSSSSSSSSSSSSSSSS.TTTTTTTTTTTTTTTTTTTTTTTTTTTTTTTTTTTTTTTTT
UUUUUUUUUUUUUUUUUUUUUUUUUUUUUUUU.SSSSSSSSSSSSSSSSSSSSSSSSSSSSSSSSSSSS.TTTTTTTTTTTTTTTTTTTTTTTTTTTTTTTTTTTTTTTTT
UUUUUUUUUUUUUUUUUUUUUUUUUUUUUUUU.SSSSSSSSSSSSSSSSSSSSSSSSSSSSSSSSSSSS.TTTTTTTTTTTTTTTTTTTTTTTTTTTTTTTTTTTTTTTTT
UUUUUUUUUUUUUUUUUUUUUUUUUUUUUUUU.SSSSSSSSSSSSSSSSSSSSSSSSSSSSSSSSSSSS.TTTTTTTTTTTTTTTTTTTTTTTTTTTTTTTTTTTTTTTTT
UUUUUUUUUUUUUUUUUUUUUUUUUUUUUUUU.SSSSSSSSSSSSSSSSSSSSSSSSSSSSSSSSSSSS.TTTTTTTTTTTTTTTTTTTTTTTTTTTTTTTTTTTTTTTTT
UUUUUUUUUUUUUUUUUUUUUUUUUUUUUUUU.SSSSSSSSSSSSSSSSSSSSSSSSSSSSSSSSSSSS.TTTTTTTTTTTTTTTTTTTTTTTTTTTTTTTTTTTTTTTTT
UUUUUUUUUUUUUUUUUUUUUUUUUUUUUUUU.SSSSSSSSSSSSSSSSSSSSSSSSSSSSSSSSSSSS.TTTTTTTTTTTTTTTTTTTTTTTTTTTTTTTTTTTTTTTTT
UUUUUUUUUUUUUUUUUUUUUUUUUUUUUUUU.SSSSSSSSSSSSSSSSSSSSSSSSSSSSSSSSSSSS.TTTTTTTTTTTTTTTTTTTTTTTTTTTTTTTTTTTTTTTTT
.................................SSSSSSSSSSSSSSSSSSSSSSSSSSSSSSSSSSSS.TTTTTTTTTTTTTTTTTTTTTTTTTTTTTTTTTTTTTTTTT
KKKKKKKKKKKKKKKKKKKKKKKKKKKK.RRR.SSSSSSSSSSSSSSSSSSSSSSSSSSSSSSSSSSSS.TTTTTTTTTTTTTTTTTTTTTTTTTTTTTTTTTTTTTTTTT
KKKKKKKKKKKKKKKKKKKKKKKKKKKK.RRR.SSSSSSSSSSSSSSSSSSSSSSSSSSSSSSSSSSSS.TTTTTTTTTTTTTTTTTTTTTTTTTTTTTTTTTTTTTTTTT
KKKKKKKKKKKKKKKKKKKKKKKKKKKK.RRR.SSSSSSSSSSSSSSSSSSSSSSSSSSSSSSSSSSSS.TTTTTTTTTTTTTTTTTTTTTTTTTTTTTTTTTTTTTTTTT
KKKKKKKKKKKKKKKKKKKKKKKKKKKK..........................................TTTTTTTTTTTTTTTTTTTTTTTTTTTTTTTTTTTTTTTTT
KKKKKKKKKKKKKKKKKKKKKKKKKKKK.LLLLLLLLLLLLLLLLLLLLLLLL.PPPPPPPPPPPPPPP.TTTTTTTTTTTTTTTTTTTTTTTTTTTTTTTTTTTTTTTTT
KKKKKKKKKKKKKKKKKKKKKKKKKKKK.LLLLLLLLLLLLLLLLLLLLLLLL.PPPPPPPPPPPPPPP.TTTTTTTTTTTTTTTTTTTTTTTTTTTTTTTTTTTTTTTTT
KKKKKKKKKKKKKKKKKKKKKKKKKKKK.LLLLLLLLLLLLLLLLLLLLLLLL.PPPPPPPPPPPPPPP.TTTTTTTTTTTTTTTTTTTTTTTTTTTTTTTTTTTTTTTTT
KKKKKKKKKKKKKKKKKKKKKKKKKKKK.LLLLLLLLLLLLLLLLLLLLLLLL.PPPPPPPPPPPPPPP.TTTTTTTTTTTTTTTTTTTTTTTTTTTTTTTTTTTTTTTTT
KKKKKKKKKKKKKKKKKKKKKKKKKKKK.LLLLLLLLLLLLLLLLLLLLLLLL.PPPPPPPPPPPPPPP..........................................
KKKKKKKKKKKKKKKKKKKKKKKKKKKK.LLLLLLLLLLLLLLLLLLLLLLLL.PPPPPPPPPPPPPPP.QQQQQQQQQQQQQQQQQ.JJJJJJJJJJJJJJJJJJJJJJJ
KKKKKKKKKKKKKKKKKKKKKKKKKKKK.LLLLLLLLLLLLLLLLLLLLLLLL.PPPPPPPPPPPPPPP.QQQQQQQQQQQQQQQQQ.JJJJJJJJJJJJJJJJJJJJJJJ
KKKKKKKKKKKKKKKKKKKKKKKKKKKK.LLLLLLLLLLLLLLLLLLLLLLLL.PPPPPPPPPPPPPPP.QQQQQQQQQQQQQQQQQ.JJJJJJJJJJJJJJJJJJJJJJJ
KKKKKKKKKKKKKKKKKKKKKKKKKKKK.LLLLLLLLLLLLLLLLLLLLLLLL.PPPPPPPPPPPPPPP.QQQQQQQQQQQQQQQQQ.JJJJJJJJJJJJJJJJJJJJJJJ
KKKKKKKKKKKKKKKKKKKKKKKKKKKK.LLLLLLLLLLLLLLLLLLLLLLLL.PPPPPPPPPPPPPPP.QQQQQQQQQQQQQQQQQ.JJJJJJJJJJJJJJJJJJJJJJJ
KKKKKKKKKKKKKKKKKKKKKKKKKKKK.LLLLLLLLLLLLLLLLLLLLLLLL.PPPPPPPPPPPPPPP.QQQQQQQQQQQQQQQQQ.JJJJJJJJJJJJJJJJJJJJJJJ
KKKKKKKKKKKKKKKKKKKKKKKKKKKK.LLLLLLLLLLLLLLLLLLLLLLLL.PPPPPPPPPPPPPPP.QQQQQQQQQQQQQQQQQ.JJJJJJJJJJJJJJJJJJJJJJJ
KKKKKKKKKKKKKKKKKKKKKKKKKKKK.LLLLLLLLLLLLLLLLLLLLLLLL.PPPPPPPPPPPPPPP.QQQQQQQQQQQQQQQQQ.JJJJJJJJJJJJJJJJJJJJJJJ
KKKKKKKKKKKKKKKKKKKKKKKKKKKK.LLLLLLLLLLLLLLLLLLLLLLLL.PPPPPPPPPPPPPPP.QQQQQQQQQQQQQQQQQ.JJJJJJJJJJJJJJJJJJJJJJJ
KKKKKKKKKKKKKKKKKKKKKKKKKKKK.LLLLLLLLLLLLLLLLLLLLLLLL.PPPPPPPPPPPPPPP.QQQQQQQQQQQQQQQQQ.JJJJJJJJJJJJJJJJJJJJJJJ
KKKKKKKKKKKKKKKKKKKKKKKKKKKK.LLLLLLLLLLLLLLLLLLLLLLLL.................QQQQQQQQQQQQQQQQQ.JJJJJJJJJJJJJJJJJJJJJJJ
KKKKKKKKKKKKKKKKKKKKKKKKKKKK.LLLLLLLLLLLLLLLLLLLLLLLL.MMMMMMMM.OOOOOO.QQQQQQQQQQQQQQQQQ.JJJJJJJJJJJJJJJJJJJJJJJ
KKKKKKKKKKKKKKKKKKKKKKKKKKKK.LLLLLLLLLLLLLLLLLLLLLLLL.MMMMMMMM.OOOOOO.QQQQQQQQQQQQQQQQQ.JJJJJJJJJJJJJJJJJJJJJJJ
KKKKKKKKKKKKKKKKKKKKKKKKKKKK.LLLLLLLLLLLLLLLLLLLLLLLL.MMMMMMMM.OOOOOO.QQQQQQQQQQQQQQQQQ.JJJJJJJJJJJJJJJJJJJJJJJ
KKKKKKKKKKKKKKKKKKKKKKKKKKKK.LLLLLLLLLLLLLLLLLLLLLLLL.MMMMMMMM.OOOOOO.QQQQQQQQQQQQQQQQQ.JJJJJJJJJJJJJJJJJJJJJJJ
KKKKKKKKKKKKKKKKKKKKKKKKKKKK.LLLLLLLLLLLLLLLLLLLLLLLL.MMMMMMMM.OOOOOO.QQQQQQQQQQQQQQQQQ.JJJJJJJJJJJJJJJJJJJJJJJ
KKKKKKKKKKKKKKKKKKKKKKKKKKKK.LLLLLLLLLLLLLLLLLLLLLLLL.MMMMMMMM.OOOOOO.QQQQQQQQQQQQQQQQQ.JJJJJJJJJJJJJJJJJJJJJJJ
KKKKKKKKKKKKKKKKKKKKKKKKKKKK.LLLLLLLLLLLLLLLLLLLLLLLL.MMMMMMMM..........................JJJJJJJJJJJJJJJJJJJJJJJ
KKKKKKKKKKKKKKKKKKKKKKKKKKKK.LLLLLLLLLLLLLLLLLLLLLLLL.MMMMMMMM.N.GGGGGGGGGGGGGGGG.IIIII.JJJJJJJJJJJJJJJJJJJJJJJ
.................................................................GGGGGGGGGGGGGGGG.IIIII.JJJJJJJJJJJJJJJJJJJJJJJ
AAAAAAAAAAAAAAAAAAAAAAAAAAAAAAAAAAAAAAAAAAAAAAAAA.FFFFFFFFFFFFFF.GGGGGGGGGGGGGGGG.IIIII.JJJJJJJJJJJJJJJJJJJJJJJ
AAAAAAAAAAAAAAAAAAAAAAAAAAAAAAAAAAAAAAAAAAAAAAAAA.FFFFFFFFFFFFFF.GGGGGGGGGGGGGGGG.IIIII.JJJJJJJJJJJJJJJJJJJJJJJ
AAAAAAAAAAAAAAAAAAAAAAAAAAAAAAAAAAAAAAAAAAAAAAAAA.FFFFFFFFFFFFFF.GGGGGGGGGGGGGGGG.IIIII.JJJJJJJJJJJJJJJJJJJJJJJ
AAAAAAAAAAAAAAAAAAAAAAAAAAAAAAAAAAAAAAAAAAAAAAAAA.FFFFFFFFFFFFFF.GGGGGGGGGGGGGGGG..............................
AAAAAAAAAAAAAAAAAAAAAAAAAAAAAAAAAAAAAAAAAAAAAAAAA.FFFFFFFFFFFFFF.GGGGGGGGGGGGGGGG.HHHHHHHHHH.EEEEEEEEEEEEEEEEEE
AAAAAAAAAAAAAAAAAAAAAAAAAAAAAAAAAAAAAAAAAAAAAAAAA.FFFFFFFFFFFFFF.GGGGGGGGGGGGGGGG.HHHHHHHHHH.EEEEEEEEEEEEEEEEEE
AAAAAAAAAAAAAAAAAAAAAAAAAAAAAAAAAAAAAAAAAAAAAAAAA.FFFFFFFFFFFFFF.GGGGGGGGGGGGGGGG.HHHHHHHHHH.EEEEEEEEEEEEEEEEEE
AAAAAAAAAAAAAAAAAAAAAAAAAAAAAAAAAAAAAAAAAAAAAAAAA.FFFFFFFFFFFFFF.GGGGGGGGGGGGGGGG.HHHHHHHHHH.EEEEEEEEEEEEEEEEEE
AAAAAAAAAAAAAAAAAAAAAAAAAAAAAAAAAAAAAAAAAAAAAAAAA.FFFFFFFFFFFFFF.GGGGGGGGGGGGGGGG.HHHHHHHHHH.EEEEEEEEEEEEEEEEEE
AAAAAAAAAAAAAAAAAAAAAAAAAAAAAAAAAAAAAAAAAAAAAAAAA.FFFFFFFFFFFFFF.GGGGGGGGGGGGGGGG.HHHHHHHHHH.EEEEEEEEEEEEEEEEEE
AAAAAAAAAAAAAAAAAAAAAAAAAAAAAAAAAAAAAAAAAAAAAAAAA.FFFFFFFFFFFFFF.GGGGGGGGGGGGGGGG.HHHHHHHHHH.EEEEEEEEEEEEEEEEEE
AAAAAAAAAAAAAAAAAAAAAAAAAAAAAAAAAAAAAAAAAAAAAAAAA.FFFFFFFFFFFFFF.GGGGGGGGGGGGGGGG.HHHHHHHHHH.EEEEEEEEEEEEEEEEEE
AAAAAAAAAAAAAAAAAAAAAAAAAAAAAAAAAAAAAAAAAAAAAAAAA.FFFFFFFFFFFFFF.GGGGGGGGGGGGGGGG.HHHHHHHHHH.EEEEEEEEEEEEEEEEEE
AAAAAAAAAAAAAAAAAAAAAAAAAAAAAAAAAAAAAAAAAAAAAAAAA.FFFFFFFFFFFFFF.GGGGGGGGGGGGGGGG.HHHHHHHHHH.EEEEEEEEEEEEEEEEEE
AAAAAAAAAAAAAAAAAAAAAAAAAAAAAAAAAAAAAAAAAAAAAAAAA............................................EEEEEEEEEEEEEEEEEE
AAAAAAAAAAAAAAAAAAAAAAAAAAAAAAAAAAAAAAAAAAAAAAAAA.BBBBBBBBBBBBBBBBBBBBBBBBBBBBBBBBBB.DDDDDDD.EEEEEEEEEEEEEEEEEE
AAAAAAAAAAAAAAAAAAAAAAAAAAAAAAAAAAAAAAAAAAAAAAAAA.BBBBBBBBBBBBBBBBBBBBBBBBBBBBBBBBBB.DDDDDDD.EEEEEEEEEEEEEEEEEE
AAAAAAAAAAAAAAAAAAAAAAAAAAAAAAAAAAAAAAAAAAAAAAAAA.BBBBBBBBBBBBBBBBBBBBBBBBBBBBBBBBBB.DDDDDDD.EEEEEEEEEEEEEEEEEE
AAAAAAAAAAAAAAAAAAAAAAAAAAAAAAAAAAAAAAAAAAAAAAAAA.BBBBBBBBBBBBBBBBBBBBBBBBBBBBBBBBBB.DDDDDDD.EEEEEEEEEEEEEEEEEE
AAAAAAAAAAAAAAAAAAAAAAAAAAAAAAAAAAAAAAAAAAAAAAAAA.BBBBBBBBBBBBBBBBBBBBBBBBBBBBBBBBBB.DDDDDDD.EEEEEEEEEEEEEEEEEE
AAAAAAAAAAAAAAAAAAAAAAAAAAAAAAAAAAAAAAAAAAAAAAAAA.BBBBBBBBBBBBBBBBBBBBBBBBBBBBBBBBBB.DDDDDDD.EEEEEEEEEEEEEEEEEE
AAAAAAAAAAAAAAAAAAAAAAAAAAAAAAAAAAAAAAAAAAAAAAAAA.BBBBBBBBBBBBBBBBBBBBBBBBBBBBBBBBBB.DDDDDDD.EEEEEEEEEEEEEEEEEE
AAAAAAAAAAAAAAAAAAAAAAAAAAAAAAAAAAAAAAAAAAAAAAAAA.BBBBBBBBBBBBBBBBBBBBBBBBBBBBBBBBBB...........................
AAAAAAAAAAAAAAAAAAAAAAAAAAAAAAAAAAAAAAAAAAAAAAAAA.BBBBBBBBBBBBBBBBBBBBBBBBBBBBBBBBBB.CCCCCCCCCCCCCCCCCCCCCCCCCC
AAAAAAAAAAAAAAAAAAAAAAAAAAAAAAAAAAAAAAAAAAAAAAAAA.BBBBBBBBBBBBBBBBBBBBBBBBBBBBBBBBBB.CCCCCCCCCCCCCCCCCCCCCCCCCC
AAAAAAAAAAAAAAAAAAAAAAAAAAAAAAAAAAAAAAAAAAAAAAAAA.BBBBBBBBBBBBBBBBBBBBBBBBBBBBBBBBBB.CCCCCCCCCCCCCCCCCCCCCCCCCC
AAAAAAAAAAAAAAAAAAAAAAAAAAAAAAAAAAAAAAAAAAAAAAAAA.BBBBBBBBBBBBBBBBBBBBBBBBBBBBBBBBBB.CCCCCCCCCCCCCCCCCCCCCCCCCC
AAAAAAAAAAAAAAAAAAAAAAAAAAAAAAAAAAAAAAAAAAAAAAAAA.BBBBBBBBBBBBBBBBBBBBBBBBBBBBBBBBBB.CCCCCCCCCCCCCCCCCCCCCCCCCC
AAAAAAAAAAAAAAAAAAAAAAAAAAAAAAAAAAAAAAAAAAAAAAAAA.BBBBBBBBBBBBBBBBBBBBBBBBBBBBBBBBBB.CCCCCCCCCCCCCCCCCCCCCCCCCC
AAAAAAAAAAAAAAAAAAAAAAAAAAAAAAAAAAAAAAAAAAAAAAAAA.BBBBBBBBBBBBBBBBBBBBBBBBBBBBBBBBBB.CCCCCCCCCCCCCCCCCCCCCCCCCC
AAAAAAAAAAAAAAAAAAAAAAAAAAAAAAAAAAAAAAAAAAAAAAAAA.BBBBBBBBBBBBBBBBBBBBBBBBBBBBBBBBBB.CCCCCCCCCCCCCCCCCCCCCCCCCC
AAAAAAAAAAAAAAAAAAAAAAAAAAAAAAAAAAAAAAAAAAAAAAAAA.BBBBBBBBBBBBBBBBBBBBBBBBBBBBBBBBBB.CCCCCCCCCCCCCCCCCCCCCCCCCC
AAAAAAAAAAAAAAAAAAAAAAAAAAAAAAAAAAAAAAAAAAAAAAAAA.BBBBBBBBBBBBBBBBBBBBBBBBBBBBBBBBBB.CCCCCCCCCCCCCCCCCCCCCCCCCC
AAAAAAAAAAAAAAAAAAAAAAAAAAAAAAAAAAAAAAAAAAAAAAAAA.BBBBBBBBBBBBBBBBBBBBBBBBBBBBBBBBBB.CCCCCCCCCCCCCCCCCCCCCCCCCC
AAAAAAAAAAAAAAAAAAAAAAAAAAAAAAAAAAAAAAAAAAAAAAAAA.BBBBBBBBBBBBBBBBBBBBBBBBBBBBBBBBBB.CCCCCCCCCCCCCCCCCCCCCCCCCC
AAAAAAAAAAAAAAAAAAAAAAAAAAAAAAAAAAAAAAAAAAAAAAAAA.BBBBBBBBBBBBBBBBBBBBBBBBBBBBBBBBBB.CCCCCCCCCCCCCCCCCCCCCCCCCC
AAAAAAAAAAAAAAAAAAAAAAAAAAAAAAAAAAAAAAAAAAAAAAAAA.BBBBBBBBBBBBBBBBBBBBBBBBBBBBBBBBBB.CCCCCCCCCCCCCCCCCCCCCCCCCC
AAAAAAAAAAAAAAAAAAAAAAAAAAAAAAAAAAAAAAAAAAAAAAAAA.BBBBBBBBBBBBBBBBBBBBBBBBBBBBBBBBBB.CCCCCCCCCCCCCCCCCCCCCCCCCC
AAAAAAAAAAAAAAAAAAAAAAAAAAAAAAAAAAAAAAAAAAAAAAAAA.BBBBBBBBBBBBBBBBBBBBBBBBBBBBBBBBBB.CCCCCCCCCCCCCCCCCCCCCCCCCC
AAAAAAAAAAAAAAAAAAAAAAAAAAAAAAAAAAAAAAAAAAAAAAAAA.BBBBBBBBBBBBBBBBBBBBBBBBBBBBBBBBBB.CCCCCCCCCCCCCCCCCCCCCCCCCC
AAAAAAAAAAAAAAAAAAAAAAAAAAAAAAAAAAAAAAAAAAAAAAAAA.BBBBBBBBBBBBBBBBBBBBBBBBBBBBBBBBBB.CCCCCCCCCCCCCCCCCCCCCCCCCC
AAAAAAAAAAAAAAAAAAAAAAAAAAAAAAAAAAAAAAAAAAAAAAAAA.BBBBBBBBBBBBBBBBBBBBBBBBBBBBBBBBBB.CCCCCCCCCCCCCCCCCCCCCCCCCC
AAAAAAAAAAAAAAAAAAAAAAAAAAAAAAAAAAAAAAAAAAAAAAAAA.BBBBBBBBBBBBBBBBBBBBBBBBBBBBBBBBBB.CCCCCCCCCCCCCCCCCCCCCCCCCC
AAAAAAAAAAAAAAAAAAAAAAAAAAAAAAAAAAAAAAAAAAAAAAAAA.BBBBBBBBBBBBBBBBBBBBBBBBBBBBBBBBBB.CCCCCCCCCCCCCCCCCCCCCCCCCC
AAAAAAAAAAAAAAAAAAAAAAAAAAAAAAAAAAAAAAAAAAAAAAAAA.BBBBBBBBBBBBBBBBBBBBBBBBBBBBBBBBBB.CCCCCCCCCCCCCCCCCCCCCCCCCC
AAAAAAAAAAAAAAAAAAAAAAAAAAAAAAAAAAAAAAAAAAAAAAAAA.BBBBBBBBBBBBBBBBBBBBBBBBBBBBBBBBBB.CCCCCCCCCCCCCCCCCCCCCCCCCC
AAAAAAAAAAAAAAAAAAAAAAAAAAAAAAAAAAAAAAAAAAAAAAAAA.BBBBBBBBBBBBBBBBBBBBBBBBBBBBBBBBBB.CCCCCCCCCCCCCCCCCCCCCCCCCC
AAAAAAAAAAAAAAAAAAAAAAAAAAAAAAAAAAAAAAAAAAAAAAAAA.BBBBBBBBBBBBBBBBBBBBBBBBBBBBBBBBBB.CCCCCCCCCCCCCCCCCCCCCCCCCC
AAAAAAAAAAAAAAAAAAAAAAAAAAAAAAAAAAAAAAAAAAAAAAAAA.BBBBBBBBBBBBBBBBBBBBBBBBBBBBBBBBBB.CCCCCCCCCCCCCCCCCCCCCCCCCC
